100 100
##....##....##....##....##....##....##....##....##....##....##....##....##....##....##....##....##..
##..#..#..#..#..#..#..#..#..#..#..#..#..#..#..#..#..#..#..#..#..#..#..#..#..#..#..#..#..#..#..#..#.B
..#..#..#..#..#..#..#..#..#..#..#..#..#..#..#..#..#..#..#..#..#..#..#..#..#..#..#..#..#..#..#..#..#.
...#..#..#..#..#..#..#..#..#..#..#..#..#..#..#..#..#..#..#..#..#..#..#..#..#..#..#..#..#..#..#..#...
.#..#..#..#..#..#..#..#..#..#..#..#..#..#..#..#..#..#..#..#..#..#..#..#..#..#..#..#..#..#..#..#..#..
..#..#..#..#..#..#..#..#..#..#..#..#..#..#..#..#..#..#..#..#..#..#..#..#..#..#..#..#..#..#..#..#..##
#..#..#..#..#..#..#..#..#..#..#..#..#..#..#..#..#..#..#..#..#..#..#..#..#..#..#..#..#..#..#..#..#..#
##..#..#..#..#..#..#..#..#..#..#..#..#..#..#..#..#..#..#..#..#..#..#..#..#..#..#..#..#..#..#..#..#..
..#..#..#..#..#..#..#..#..#..#..#..#..#..#..#..#..#..#..#..#..#..#..#..#..#..#..#..#..#..#..#..#..#.
...#..#..#..#..#..#..#..#..#..#..#..#..#..#..#..#..#..#..#..#..#..#..#..#..#..#..#..#..#..#..#..#...
.#..#..#..#..#..#..#..#..#..#..#..#..#..#..#..#..#..#..#..#..#..#..#..#..#..#..#..#..#..#..#..#..#..
..#..#..#..#..#..#..#..#..#..#..#..#..#..#..#..#..#..#..#..#..#..#..#..#..#..#..#..#..#..#..#..#..##
#..#..#..#..#..#..#..#..#..#..#..#..#..#..#..#..#..#..#..#..#..#..#..#..#..#..#..#..#..#..#..#..#..#
##..#..#..#..#..#..#..#..#..#..#..#..#..#..#..#..#..#..#..#..#..#..#..#..#..#..#..#..#..#..#..#..#..
..#..#..#..#..#..#..#..#..#..#..#..#..#..#..#..#..#..#..#..#..#..#..#..#..#..#..#..#..#..#..#..#..#.
...#..#..#..#..#..#..#..#..#..#..#..#..#..#..#..#..#..#..#..#..#..#..#..#..#..#..#..#..#..#..#..#...
.#..#..#..#..#..#..#..#..#..#..#..#..#..#..#..#..#..#..#..#..#..#..#..#..#..#..#..#..#..#..#..#..#..
..#..#..#..#..#..#..#..#..#..#..#..#..#..#..#..#..#..#..#..#..#..#..#..#..#..#..#..#..#..#..#..#..##
#..#..#..#..#..#..#..#..#..#..#..#..#..#..#..#..#..#..#..#..#..#..#..#..#..#..#..#..#..#..#..#..#..#
##..#..#..#..#..#..#..#..#..#..#..#..#..#..#..#..#..#..#..#..#..#..#..#..#..#..#..#..#..#..#..#..#..
..#..#..#..#..#..#..#..#..#..#..#..#..#..#..#..#..#..#..#..#..#..#..#..#..#..#..#..#..#..#..#..#..#.
...#..#..#..#..#..#..#..#..#..#..#..#..#..#..#..#..#..#..#..#..#..#..#..#..#..#..#..#..#..#..#..#...
.#..#..#..#..#..#..#..#..#..#..#..#..#..#..#..#..#..#..#..#..#..#..#..#..#..#..#..#..#..#..#..#..#..
..#..#..#..#..#..#..#..#..#..#..#..#..#..#..#..#..#..#..#..#..#..#..#..#..#..#..#..#..#..#..#..#..##
#..#..#..#..#..#..#..#..#..#..#..#..#..#..#..#..#..#..#..#..#..#..#..#..#..#..#..#..#..#..#..#..#..#
##..#..#..#..#..#..#..#..#..#..#..#..#..#..#..#..#..#..#..#..#..#..#..#..#..#..#..#..#..#..#..#..#..
..#..#..#..#..#..#..#..#..#..#..#..#..#..#..#..#..#..#..#..#..#..#..#..#..#..#..#..#..#..#..#..#..#.
...#..#..#..#..#..#..#..#..#..#..#..#..#..#..#..#..#..#..#..#..#..#..#..#..#..#..#..#..#..#..#..#...
.#..#..#..#..#..#..#..#..#..#..#..#..#..#..#..#..#..#..#..#..#..#..#..#..#..#..#..#..#..#..#..#..#..
..#..#..#..#..#..#..#..#..#..#..#..#..#..#..#..#..#..#..#..#..#..#..#..#..#..#..#..#..#..#..#..#..##
#..#..#..#..#..#..#..#..#..#..#..#..#..#..#..#..#..#..#..#..#..#..#..#..#..#..#..#..#..#..#..#..#..#
##..#..#..#..#..#..#..#..#..#..#..#..#..#..#..#..#..#..#..#..#..#..#..#..#..#..#..#..#..#..#..#..#..
..#..#..#..#..#..#..#..#..#..#..#..#..#..#..#..#..#..#..#..#..#..#..#..#..#..#..#..#..#..#..#..#..#.
...#..#..#..#..#..#..#..#..#..#..#..#..#..#..#..#..#..#..#..#..#..#..#..#..#..#..#..#..#..#..#..#...
.#..#..#..#..#..#..#..#..#..#..#..#..#..#..#..#..#..#..#..#..#..#..#..#..#..#..#..#..#..#..#..#..#..
..#..#..#..#..#..#..#..#..#..#..#..#..#..#..#..#..#..#..#..#..#..#..#..#..#..#..#..#..#..#..#..#..##
#..#..#..#..#..#..#..#..#..#..#..#..#..#..#..#..#..#..#..#..#..#..#..#..#..#..#..#..#..#..#..#..#..#
##..#..#..#..#..#..#..#..#..#..#..#..#..#..#..#..#..#..#..#..#..#..#..#..#..#..#..#..#..#..#..#..#..
..#..#..#..#..#..#..#..#..#..#..#..#..#..#..#..#..#..#..#..#..#..#..#..#..#..#..#..#..#..#..#..#..#.
...#..#..#..#..#..#..#..#..#..#..#..#..#..#..#..#..#..#..#..#..#..#..#..#..#..#..#..#..#..#..#..#...
.#..#..#..#..#..#..#..#..#..#..#..#..#..#..#..#..#..#..#..#..#..#..#..#..#..#..#..#..#..#..#..#..#..
..#..#..#..#..#..#..#..#..#..#..#..#..#..#..#..#..#..#..#..#..#..#..#..#..#..#..#..#..#..#..#..#..##
#..#..#..#..#..#..#..#..#..#..#..#..#..#..#..#..#..#..#..#..#..#..#..#..#..#..#..#..#..#..#..#..#..#
##..#..#..#..#..#..#..#..#..#..#..#..#..#..#..#..#..#..#..#..#..#..#..#..#..#..#..#..#..#..#..#..#..
..#..#..#..#..#..#..#..#..#..#..#..#..#..#..#..#..#..#..#..#..#..#..#..#..#..#..#..#..#..#..#..#..#.
...#..#..#..#..#..#..#..#..#..#..#..#..#..#..#..#..#..#..#..#..#..#..#..#..#..#..#..#..#..#..#..#...
.#..#..#..#..#..#..#..#..#..#..#..#..#..#..#..#..#..#..#..#..#..#..#..#..#..#..#..#..#..#..#..#..#..
..#..#..#..#..#..#..#..#..#..#..#..#..#..#..#..#..#..#..#..#..#..#..#..#..#..#..#..#..#..#..#..#..##
#..#..#..#..#..#..#..#..#..#..#..#..#..#..#..#..#..#..#..#..#..#..#..#..#..#..#..#..#..#..#..#..#..#
##..#..#..#..#..#..#..#..#..#..#..#..#..#..#..#..#..#..#..#..#..#..#..#..#..#..#..#..#..#..#..#..#..
..#..#..#..#..#..#..#..#..#..#..#..#..#..#..#..#..#..#..#..#..#..#..#..#..#..#..#..#..#..#..#..#..#.
...#..#..#..#..#..#..#..#..#..#..#..#..#..#..#..#..#..#..#..#..#..#..#..#..#..#..#..#..#..#..#..#...
.#..#..#..#..#..#..#..#..#..#..#..#..#..#..#..#..#..#..#..#..#..#..#..#..#..#..#..#..#..#..#..#..#..
..#..#..#..#..#..#..#..#..#..#..#..#..#..#..#..#..#..#..#..#..#..#..#..#..#..#..#..#..#..#..#..#..##
#..#..#..#..#..#..#..#..#..#..#..#..#..#..#..#..#..#..#..#..#..#..#..#..#..#..#..#..#..#..#..#..#..#
##..#..#..#..#..#..#..#..#..#..#..#..#..#..#..#..#..#..#..#..#..#..#..#..#..#..#..#..#..#..#..#..#..
..#..#..#..#..#..#..#..#..#..#..#..#..#..#..#..#..#..#..#..#..#..#..#..#..#..#..#..#..#..#..#..#..#.
...#..#..#..#..#..#..#..#..#..#..#..#..#..#..#..#..#..#..#..#..#..#..#..#..#..#..#..#..#..#..#..#...
.#..#..#..#..#..#..#..#..#..#..#..#..#..#..#..#..#..#..#..#..#..#..#..#..#..#..#..#..#..#..#..#..#..
..#..#..#..#..#..#..#..#..#..#..#..#..#..#..#..#..#..#..#..#..#..#..#..#..#..#..#..#..#..#..#..#..##
#..#..#..#..#..#..#..#..#..#..#..#..#..#..#..#..#..#..#..#..#..#..#..#..#..#..#..#..#..#..#..#..#..#
##..#..#..#..#..#..#..#..#..#..#..#..#..#..#..#..#..#..#..#..#..#..#..#..#..#..#..#..#..#..#..#..#..
..#..#..#..#..#..#..#..#..#..#..#..#..#..#..#..#..#..#..#..#..#..#..#..#..#..#..#..#..#..#..#..#..#.
...#..#..#..#..#..#..#..#..#..#..#..#..#..#..#..#..#..#..#..#..#..#..#..#..#..#..#..#..#..#..#..#...
.#..#..#..#..#..#..#..#..#..#..#..#..#..#..#..#..#..#..#..#..#..#..#..#..#..#..#..#..#..#..#..#..#..
..#..#..#..#..#..#..#..#..#..#..#..#..#..#..#..#..#..#..#..#..#..#..#..#..#..#..#..#..#..#..#..#..##
#..#..#..#..#..#..#..#..#..#..#..#..#..#..#..#..#..#..#..#..#..#..#..#..#..#..#..#..#..#..#..#..#..#
##..#..#..#..#..#..#..#..#..#..#..#..#..#..#..#..#..#..#..#..#..#..#..#..#..#..#..#..#..#..#..#..#..
..#..#..#..#..#..#..#..#..#..#..#..#..#..#..#..#..#..#..#..#..#..#..#..#..#..#..#..#..#..#..#..#..#.
...#..#..#..#..#..#..#..#..#..#..#..#..#..#..#..#..#..#..#..#..#..#..#..#..#..#..#..#..#..#..#..#...
.#..#..#..#..#..#..#..#..#..#..#..#..#..#..#..#..#..#..#..#..#..#..#..#..#..#..#..#..#..#..#..#..#..
..#..#..#..#..#..#..#..#..#..#..#..#..#..#..#..#..#..#..#..#..#..#..#..#..#..#..#..#..#..#..#..#..##
#..#..#..#..#..#..#..#..#..#..#..#..#..#..#..#..#..#..#..#..#..#..#..#..#..#..#..#..#..#..#..#..#..#
##..#..#..#..#..#..#..#..#..#..#..#..#..#..#..#..#..#..#..#..#..#..#..#..#..#..#..#..#..#..#..#..#..
..#..#..#..#..#..#..#..#..#..#..#..#..#..#..#..#..#..#..#..#..#..#..#..#..#..#..#..#..#..#..#..#..#.
...#..#..#..#..#..#..#..#..#..#..#..#..#..#..#..#..#..#..#..#..#..#..#..#..#..#..#..#..#..#..#..#...
.#..#..#..#..#..#..#..#..#..#..#..#..#..#..#..#..#..#..#..#..#..#..#..#..#..#..#..#..#..#..#..#..#..
..#..#..#..#..#..#..#..#..#..#..#..#..#..#..#..#..#..#..#..#..#..#..#..#..#..#..#..#..#..#..#..#..##
#..#..#..#..#..#..#..#..#..#..#..#..#..#..#..#..#..#..#..#..#..#..#..#..#..#..#..#..#..#..#..#..#..#
##..#..#..#..#..#..#..#..#..#..#..#..#..#..#..#..#..#..#..#..#..#..#..#..#..#..#..#..#..#..#..#..#..
..#..#..#..#..#..#..#..#..#..#..#..#..#..#..#..#..#..#..#..#..#..#..#..#..#..#..#..#..#..#..#..#..#.
...#..#..#..#..#..#..#..#..#..#..#..#..#..#..#..#..#..#..#..#..#..#..#..#..#..#..#..#..#..#..#..#...
.#..#..#..#..#..#..#..#..#..#..#..#..#..#..#..#..#..#..#..#..#..#..#..#..#..#..#..#..#..#..#..#..#..
..#..#..#..#..#..#..#..#..#..#..#..#..#..#..#..#..#..#..#..#..#..#..#..#..#..#..#..#..#..#..#..#..##
#..#..#..#..#..#..#..#..#..#..#..#..#..#..#..#..#..#..#..#..#..#..#..#..#..#..#..#..#..#..#..#..#..#
##..#..#..#..#..#..#..#..#..#..#..#..#..#..#..#..#..#..#..#..#..#..#..#..#..#..#..#..#..#..#..#..#..
..#..#..#..#..#..#..#..#..#..#..#..#..#..#..#..#..#..#..#..#..#..#..#..#..#..#..#..#..#..#..#..#..#.
...#..#..#..#..#..#..#..#..#..#..#..#..#..#..#..#..#..#..#..#..#..#..#..#..#..#..#..#..#..#..#..#...
.#..#..#..#..#..#..#..#..#..#..#..#..#..#..#..#..#..#..#..#..#..#..#..#..#..#..#..#..#..#..#..#..#..
..#..#..#..#..#..#..#..#..#..#..#..#..#..#..#..#..#..#..#..#..#..#..#..#..#..#..#..#..#..#..#..#..##
#..#..#..#..#..#..#..#..#..#..#..#..#..#..#..#..#..#..#..#..#..#..#..#..#..#..#..#..#..#..#..#..#..#
##..#..#..#..#..#..#..#..#..#..#..#..#..#..#..#..#..#..#..#..#..#..#..#..#..#..#..#..#..#..#..#..#..
..#..#..#..#..#..#..#..#..#..#..#..#..#..#..#..#..#..#..#..#..#..#..#..#..#..#..#..#..#..#..#..#..#.
...#..#..#..#..#..#..#..#..#..#..#..#..#..#..#..#..#..#..#..#..#..#..#..#..#..#..#..#..#..#..#..#...
.#..#..#..#..#..#..#..#..#..#..#..#..#..#..#..#..#..#..#..#..#..#..#..#..#..#..#..#..#..#..#..#..#..
..#..#..#..#..#..#..#..#..#..#..#..#..#..#..#..#..#..#..#..#..#..#..#..#..#..#..#..#..#..#..#..#..##
#..#..#..#..#..#..#..#..#..#..#..#..#..#..#..#..#..#..#..#..#..#..#..#..#..#..#..#..#..#..#..#..#..#
##..#..#..#..#..#..#..#..#..#..#..#..#..#..#..#..#..#..#..#..#..#..#..#..#..#..#..#..#..#..#..#..#..
.A#..#..#..#..#..#..#..#..#..#..#..#..#..#..#..#..#..#..#..#..#..#..#..#..#..#..#..#..#..#..#..#..#.
.....##....##....##....##....##....##....##....##....##....##....##....##....##....##....##....##...
0 0
